EXER_2+11
An Interactive Fiction by Team8
Release 1 / Serial number 180411 / Inform 7 build 6M62 (I6/v6.33 lib 6/12N) SD

Torbogen
Du Stehst unter dem Torbogen. Im Norden ist der Innenhof Parkplatz. Im Osten ist der Eingang zum Ostflügel. Im Westen ist der Eingang zum Westflügel. Im Süden ist ein Gehweg in Richtung Exer 11.

>e
Flur
Du bist im Flur. Im Norden siehst du eine Treppe. Im Osten geht der Flur weiter. Im Süden siehst du Raum 030. Im Westen siehst du die Tür zum Torbogen.

>e
Flur
Du bist im Flur. Im Norden siehst du das WC (w). Im Osten und Westen geht der Flur weiter. Im Süden siehst du Raum 030.

>e
Flur
Du bist im Flur. Im Norden siehst du den Fahrstuhl. Im Osten und Westen geht der Flur weiter. Im Süden siehst du den Raum 029.

>e
Flur
Du bist im Flur. Im Norden siehst du Raum 023. Im Osten und Westen geht der Flur weiter.

>e
Flur
Du bist im Flur. Im Norden siehst du Raum 024. Im Osten und Westen geht der Flur weiter.

>w
Flur
Du bist im Flur. Im Norden siehst du Raum 023. Im Osten und Westen geht der Flur weiter.

>w
Flur
Du bist im Flur. Im Norden siehst du den Fahrstuhl. Im Osten und Westen geht der Flur weiter. Im Süden siehst du den Raum 029.

>w
Flur
Du bist im Flur. Im Norden siehst du das WC (w). Im Osten und Westen geht der Flur weiter. Im Süden siehst du Raum 030.

>w
Flur
Du bist im Flur. Im Norden siehst du eine Treppe. Im Osten geht der Flur weiter. Im Süden siehst du Raum 030. Im Westen siehst du die Tür zum Torbogen.

>w
Torbogen
Du Stehst unter dem Torbogen. Im Norden ist der Innenhof Parkplatz. Im Osten ist der Eingang zum Ostflügel. Im Westen ist der Eingang zum Westflügel. Im Süden ist ein Gehweg in Richtung Exer 11.

>w
Flur
Du betrittst den ersten Teil des Flures. Im Norden siehst du die erste Treppe, im Osten den westlichen Eingangsbereich unter dem Torbogen, im Süden das Labor 51 und weiter Richtung Westen den zweiten Teil des Flures.

>e
Torbogen
Du Stehst unter dem Torbogen. Im Norden ist der Innenhof Parkplatz. Im Osten ist der Eingang zum Ostflügel. Im Westen ist der Eingang zum Westflügel. Im Süden ist ein Gehweg in Richtung Exer 11.

>e
Flur
Du bist im Flur. Im Norden siehst du eine Treppe. Im Osten geht der Flur weiter. Im Süden siehst du Raum 030. Im Westen siehst du die Tür zum Torbogen.

>n
Treppe
Du stehst auf der Treppe. Im Süden ist der Flur

You can see Die Westtreppe01 here.

>go up
Treppe
Du bist im Treppenhaus im OG. Im Süden siehst du einen Flur. Über dir siehst du die Treppe zum DG. Unter dir siehst du die Treppe zum EG.

You can see Die Westtreppe01 here.

>go down
Treppe
Du stehst auf der Treppe. Im Süden ist der Flur

You can see Die Westtreppe01 here.

* * *

>e
Flur
Du bist im Flur. Im Norden siehst du Raum 024. Im Osten und Westen geht der Flur weiter.

>e
Flur
Du bist im Flur. Im Norden siehst du Raum 025. Im Osten und Westen geht der Flur weiter. Im Süden siehst du Raum 028a.

>w
Flur
Du bist im Flur. Im Norden siehst du Raum 024. Im Osten und Westen geht der Flur weiter.

>w
Flur
Du bist im Flur. Im Norden siehst du Raum 023. Im Osten und Westen geht der Flur weiter.

* * *

>w
Flur
Du bist im Flur. Im Norden siehst du eine Treppe. Im Osten geht der Flur weiter. Im Süden siehst du Raum 030. Im Westen siehst du die Tür zum Torbogen.

>n
Treppe
Du stehst auf der Treppe. Im Süden ist der Flur

>go up
Treppe
Du bist im Treppenhaus im OG. Im Süden siehst du einen Flur. Über dir siehst du die Treppe zum DG. Unter dir siehst du die Treppe zum EG.

* * *

>e
Flur
Du bist im Flur. Im Norden siehst du eine Treppe. Im Osten geht der Flur weiter. Im Süden siehst du Raum 030. Im Westen siehst du die Tür zum Torbogen.

>n
Treppe
Du stehst im Treppenhaus. Im Süden ist der Flur. Über dir ist das Obergeschoss.

>go up
Treppe
Du bist im Treppenhaus im OG. Im Süden siehst du einen Flur. Über dir siehst du die Treppe zum DG. Unter dir siehst du die Treppe zum EG.

>go down
Treppe
Du stehst auf der Treppe. Im Süden ist der Flur

>go up
Treppe
Du bist im Treppenhaus im OG. Im Süden siehst du einen Flur. Über dir siehst du die Treppe zum DG. Unter dir siehst du die Treppe zum EG.

>s
Flur
Du bist in Flur. Im Norden siehst du eine Treppe. Im Osten und westen siehst du einen Flur.

>e
Flur
Du bist in Flur. Im Norden siehst du ein Herren WC. Im Osten und Westen siehst du einen Flur. Im Süden siehst du Raum 131.

>e
Flur
Du bist in Flur. Im Norden siehst du einen Fahrsthul. Im Osten und Westen siehst du einen Flur.

>e
Flur
Du bist in Flur. Im Norden siehst du ein Behinderten WC. Im Osten und Westen siehst du einen Flur. Im Süden siehst du Raum 130.

>e
Flur
Du bist in Flur. Im Norden siehst du Raum 124. Im Osten und Westen siehst du einen Flur. Im Süden siehst du das Labor 129

>e
Flur
Du bist in Flur. Im Norden siehst du Raum 125. Im Osten und Westen siehst du einen Flur.

>e
Flur
Du bist in Flur. Im Norden siehst du Raum 126. Im Osten und Westen siehst du einen Flur.

>e
Flur
Nördlich und Westlich ist der Flur. Im Süden ist der Raum 127.

>n
Flur
Nördlich und Südlich ist der Flur. Im Westen ist der Raum 108.

>n
Flur
Nördlich, Südlich und Westlich ist der Flur. Im Osten ist der Raum 107.

>n
Flur
Nördlich und Südlich ist der Flur. Im Osten ist der Raum 107. Im Westen ist der Raum 110.

>n
Flur
Nördlich und Südlich ist der Flur. Im Osten ist der Raum 106. Im Westen ist das Treppenhaus.

>w
of TreppeOGO02

* * *

>n
Treppe
Du stehst im Treppenhaus. Im Süden ist der Flur. Über dir ist das Obergeschoss.

>up
Treppe
Du bist im Treppenhaus im OG. Im Süden siehst du einen Flur. Über dir siehst du die Treppe zum DG. Unter dir siehst du die Treppe zum EG.

>s
Flur
Du bist in Flur. Im Norden siehst du eine Treppe. Im Osten und westen siehst du einen Flur.

* * *

>n
Flur
Nördlich und Südlich ist der Flur. Im Osten ist der Raum 106. Im Westen ist das Treppenhaus.

>w
TreppeOGO02

>down
Treppe
Du stehst auf der Treppe. Im Osten ist der Flur. Im Westen siehst du den Innenhof Ost.

* * *

>up
Treppe
Du bist im Treppenhaus im OG. Im Süden siehst du einen Flur. Über dir siehst du die Treppe zum DG. Unter dir siehst du die Treppe zum EG.

>down
Treppe
Du stehst im Treppenhaus. Im Süden ist der Flur. Über dir ist das Obergeschoss.

>e
You can't go that way.

>down
You can't go that way.

>down
You can't go that way.

>s
Flur
Du bist im Flur. Im Norden siehst du eine Treppe. Im Osten geht der Flur weiter. Im Süden siehst du Raum 030. Im Westen siehst du die Tür zum Torbogen.

>n
Treppe
Du stehst auf der Treppe. Im Süden ist der Flur

>up
Treppe
Du bist im Treppenhaus im OG. Im Süden siehst du einen Flur. Über dir siehst du die Treppe zum DG. Unter dir siehst du die Treppe zum EG.

>down
Treppe
Du stehst auf der Treppe. Im Süden ist der Flur

>up
Treppe
Du bist im Treppenhaus im OG. Im Süden siehst du einen Flur. Über dir siehst du die Treppe zum DG. Unter dir siehst du die Treppe zum EG.

* * *

>down
Treppe
Du stehst auf der Treppe. Im Süden ist der Flur

>s
Flur
Du bist im Flur. Im Norden siehst du eine Treppe. Im Osten geht der Flur weiter. Im Süden siehst du Raum 030. Im Westen siehst du die Tür zum Torbogen.

>e
Flur
Du bist im Flur. Im Norden siehst du das WC (w). Im Osten und Westen geht der Flur weiter. Im Süden siehst du Raum 030.

* * *

>e
Flur
Du bist im Flur. Im Norden siehst du Raum 025. Im Osten und Westen geht der Flur weiter. Im Süden siehst du Raum 028a.

>e
Flur
Du bist im Flur. Im Osten geht der Flur weiter, dort ist ein Lernbereich. Im Süden siehst du Raum 027. Im Westen geht der Flur weiter.

>e
Lernbereich
Du bist im Lernbereich. Im Norden und Westen geht der Flur weiter. Im Süden siehst du Raum 026.

>n
Flur
Du bist im Flur. Im Norden geht der Flur weiter. Im Süden geht der Flur weiter, dort ist ein Lernbereich. Im Westen siehst du Raum 008.

>n
Flur
Du bist im Flur. Im Norden und Süden geht der Flur weiter. Im Osten siehst du Raum 007. Im Westen siehst du das WC (m).

>n
Flur
Du bist im Flur. Im Norden und Süden geht der Flur weiter. Im Osten siehst du Raum 006 - Das Labor. Im Westen siehst du Raum 010.

>n
Flur
Du bist im Flur. Im Norden und Süden geht der Flur weiter. Im Westen siehst du Raum 011.

>n
Flur
Du bist im Flur. Im Norden und Süden geht der Flur weiter. Im Osten siehst du Raum 005 - Das Labor. Im Westen siehst du Raum 012.

>n
Flur
Du bist im Flur. Im Norden und Süden geht der Flur weiter. Im Westen siehst du eine Treppe.

>w
Treppe
Du stehst auf der Treppe. Im Osten ist der Flur. Im Westen siehst du den Innenhof Ost.

>up
Treppe
Du bist im Treppenhaus

>down
Treppe
Du stehst auf der Treppe. Im Osten ist der Flur. Im Westen siehst du den Innenhof Ost.

>w
Innenhof Ost
Du bist im Innenhof Ost - die Sonne blendet und die Vögel zwitschern. Im Osten ist eine Treppe, die ins Gebäude führt. Im Süden ist der barrierefreie Zugang zum Fahrstuhl. Im Westen siehst du den Innenhof Parkplatz Ost.

>s
barrierefreier Zugang zum Fahrstuhl
Du bist im barrierefreien Zugang zum Fahrstuhl. Im Norden siehst du den Innenhof Ost. Im Süden ist der Fahrstuhl.

>s
Fahrstuhl
Du bist im Fahrstuhl. Im Norden siehst du den barrierefreien Zugang zum Fahrstuhl. Im Süden ist der Flur.

>s
Flur
Du bist im Flur. Im Norden siehst du den Fahrstuhl. Im Osten und Westen geht der Flur weiter. Im Süden siehst du den Raum 029.

>w
Flur
Du bist im Flur. Im Norden siehst du das WC (w). Im Osten und Westen geht der Flur weiter. Im Süden siehst du Raum 030.

* * *

>w
Torbogen
Du Stehst unter dem Torbogen. Im Norden ist der Innenhof Parkplatz. Im Osten ist der Eingang zum Ostflügel. Im Westen ist der Eingang zum Westflügel. Im Süden ist ein Gehweg in Richtung Exer 11.

>e
Flur
Du bist im Flur. Im Norden siehst du eine Treppe. Im Osten geht der Flur weiter. Im Süden siehst du Raum 030. Im Westen siehst du die Tür zum Torbogen.

>n
Treppe
Du stehst auf der Treppe. Im Süden ist der Flur

* * *

>s
Flur
Du bist in Flur. Im Norden siehst du eine Treppe. Im Osten und westen siehst du einen Flur.

>w
Flur
Du bist in Flur. Im Norden siehst du Raum 137. Im Osten siehst du einen Flur. Im Süden siehst du den Poolraum 132.

>w
Raum 136
Du bist im Raum 136, dem Kaminzimmer. Im Osten und Westen siehst du einen Flur.

>e
Flur
Du bist in Flur. Im Norden siehst du Raum 137. Im Osten siehst du einen Flur. Im Süden siehst du den Poolraum 132.

>e
Flur
Du bist in Flur. Im Norden siehst du eine Treppe. Im Osten und westen siehst du einen Flur.

>e
Flur
Du bist in Flur. Im Norden siehst du ein Herren WC. Im Osten und Westen siehst du einen Flur. Im Süden siehst du Raum 131.

>w
Flur
Du bist in Flur. Im Norden siehst du eine Treppe. Im Osten und westen siehst du einen Flur.

>w
Flur
Du bist in Flur. Im Norden siehst du Raum 137. Im Osten siehst du einen Flur. Im Süden siehst du den Poolraum 132.

* * *

>w
Raum 136
Du bist im Raum 136, dem Kaminzimmer. Im Osten und Westen siehst du einen Flur.

>w
Flur
Du bist in Flur. Im Norden siehst du Raum 135. Im Osten siehst du Raum136, das Kaminzimmer. Im Süden siehst du Raum 134. Im Westen siehst du einen Flur.

>w
Flur
Du bist in Flur. Im Norden siehst du eine Treppe. Im Osten und Westen siehst du einen Flur.

>n
Treppe
Du bist im Treppenhaus im OG. Im Süden siehst du einen Flur. Über dir siehst du die Treppe zum DG. Unter dir siehst du die Treppe zum EG

>down
Treppe
Du gehst die erste Treppe nach oben und betrittst das Obergeschoss im Westen.

>down
You can't go that way.

>up
Treppe
Du bist im Treppenhaus im OG. Im Süden siehst du einen Flur. Über dir siehst du die Treppe zum DG. Unter dir siehst du die Treppe zum EG

>up
You can't go that way.

>down
Treppe
Du gehst die erste Treppe nach oben und betrittst das Obergeschoss im Westen.

* * *

>down
You can't go that way.

>go down
You can't go that way.

>up
Treppe
Du bist im Treppenhaus im OG. Im Süden siehst du einen Flur. Über dir siehst du die Treppe zum DG. Unter dir siehst du die Treppe zum EG

>s
Flur
Du bist in Flur. Im Norden siehst du eine Treppe. Im Osten und Westen siehst du einen Flur.

>w
Flur
Du bist in Flur. Im Norden siehst du ein Damen WC. Im Osten und Westen siehst du einen Flur. Im Süden siehst du das Labor 151.

>w
Flur
Du bist in Flur. Im Norden siehst du Raum 158. Im Osten und Westen siehst du einen Flur. Im Süden siehst du den Hörsal 152.

>w
Flur
Du bist in Flur. Im Norden siehst du das Labor 157. Im Osten und Westen siehst du einen Flur.

>w
Flur
Du bist in Flur. Im Norden siehst du Raum 156. Im Osten und Westen siehst du einen Flur. Im Süden siehst du Raum 153.

>w
Flur
Du bist im Flur. Im Westen und Osten siehst du einen Flur. Im Süden siehst du Raum 154.

>w
Flur
Du bist im Flur. Im Norden und Osten siehst du einen Flur. Im Süden siehst du den Laborraum 155.

>n
Flur
Du bist im Flur. Im Norden und Süden siehst du einen Flur. Im Westen siehst du Raum 175. Im Osten siehst du Raum 174

>n
Flur
Du bist im Flur. Im Norden und Süden siehst du einen Flur. Im Westen siehst du Raum 176. Im Osten siehst du Raum 173

>n
Flur
Du bist im Flur. Im Norden und Süden siehst du einen Flur. Im Westen siehst du Raum 177. Im Osten siehst du Raum 172

>n
Flur
Du bist im Flur. Im Norden und Süden siehst du einen Flur. Im Westen siehst du Raum 178. Im Osten siehst du Raum 171

>n
Flur
Du bist im Flur. Im Norden und Süden siehst du einen Flur. Im Westen siehst du Raum 179.

>n
Flur
Du bist im Flur. Im Norden und Süden siehst du einen Flur. Im Westen siehst du Raum 180.

>n
Flur
Du bist im Flur. Im Norden und Süden siehst du einen Flur. Im Westen siehst du Raum 181. Im Osten siehst du Raum 185.

>n
Flur
Du bist im Flur. Im Norden und Süden siehst du einen Flur. Im Westen siehst du Raum 182. Im Osten siehst du Raum 184.

>n
Flur
Du bist im Flur. Im Süden siehst du einen Flur. Im Osten siehst du Raum 183.

>n
You can't go that way.

>s
Flur
Du bist im Flur. Im Norden und Süden siehst du einen Flur. Im Westen siehst du Raum 182. Im Osten siehst du Raum 184.

>s
Flur
Du bist im Flur. Im Norden und Süden siehst du einen Flur. Im Westen siehst du Raum 181. Im Osten siehst du Raum 185.

>s
Flur
Du bist im Flur. Im Norden und Süden siehst du einen Flur. Im Westen siehst du Raum 180.

>s
Flur
Du bist im Flur. Im Norden und Süden siehst du einen Flur. Im Westen siehst du Raum 179.

>s
Flur
Du bist im Flur. Im Norden und Süden siehst du einen Flur. Im Westen siehst du Raum 178. Im Osten siehst du Raum 171

>s
Flur
Du bist im Flur. Im Norden und Süden siehst du einen Flur. Im Westen siehst du Raum 177. Im Osten siehst du Raum 172

* * *

>down
Treppe
Du stehst im Treppenhaus. Im Süden ist der Flur. Über dir ist das Obergeschoss.

>s
Flur
Du bist im Flur. Im Norden siehst du eine Treppe. Im Osten geht der Flur weiter. Im Süden siehst du Raum 030. Im Westen siehst du die Tür zum Torbogen.

* * *

>n
Flur
Du bist im Flur. Im Norden und Süden geht der Flur weiter. Im Westen siehst du eine Treppe.

>w
Treppe
Du stehst im Treppenhaus. Im Osten ist der Flur. Im Westen siehst du den Innenhof Ost. Über dir ist das Obergeschoss.

>up
Treppe
Du bist im Treppenhaus

>down
Treppe
Du stehst im Treppenhaus. Im Osten ist der Flur. Im Westen siehst du den Innenhof Ost. Über dir ist das Obergeschoss.

>up
Treppe
Du bist im Treppenhaus

>e
Flur
Nördlich und Südlich ist der Flur. Im Osten ist der Raum 106. Im Westen ist das Treppenhaus.

* * *

EXER_2+11
An Interactive Fiction by Team8
Release 1 / Serial number 180411 / Inform 7 build 6M62 (I6/v6.33 lib 6/12N) SD

Torbogen
Du Stehst unter dem Torbogen. Im Norden ist der Innenhof Parkplatz. Im Osten ist der Eingang zum Ostflügel. Im Westen ist der Eingang zum Westflügel. Im Süden ist ein Gehweg in Richtung Exer 11.

>w
Flur
Du betrittst den ersten Teil des Flures. Im Norden siehst du die erste Treppe, im Osten den westlichen Eingangsbereich unter dem Torbogen, im Süden das Labor 51 und weiter Richtung Westen den zweiten Teil des Flures.

>w
Flur
Du betrittst den zweiten Teil des Flures. Im Norden siehst du den dritten Teil des Flures, im Osten siesht du den ersten Teil des Flures und weiter Richtung Westen den vierten Teil des Flures.

>e
Flur
Du betrittst den ersten Teil des Flures. Im Norden siehst du die erste Treppe, im Osten den westlichen Eingangsbereich unter dem Torbogen, im Süden das Labor 51 und weiter Richtung Westen den zweiten Teil des Flures.

>n
Treppe
Du gehst die erste Treppe nach oben und betrittst das Obergeschoss im Westen.

>up
Treppe
Du bist im Treppenhaus im OG. Im Süden siehst du einen Flur. Über dir siehst du die Treppe zum DG. Unter dir siehst du die Treppe zum EG

>down
Treppe
Du gehst die erste Treppe nach oben und betrittst das Obergeschoss im Westen.

>up
Treppe
Du bist im Treppenhaus im OG. Im Süden siehst du einen Flur. Über dir siehst du die Treppe zum DG. Unter dir siehst du die Treppe zum EG

* * *

>w
Flur
Du betrittst den ersten Teil des Flures. Im Norden siehst du die erste Treppe, im Osten den westlichen Eingangsbereich unter dem Torbogen, im Süden das Labor 51 und weiter Richtung Westen den zweiten Teil des Flures.

>n
Treppe
Du gehst die erste Treppe nach oben und betrittst das Obergeschoss im Westen.

* * *

>n
Flur
Du bist im Flur. Im Norden und Süden siehst du einen Flur. Im Westen siehst du Raum 178. Im Osten siehst du Raum 171

>n
Flur
Du bist im Flur. Im Norden und Süden siehst du einen Flur. Im Westen siehst du Raum 179. Im Osten ist das Treppenhaus

>e
Treppe
Du bist im Treppenhaus

>down
Treppe
Du gehst die zweite Treppe nach oben und betrittst das Obergeschoss im Westen.

* * *

EXER_2+11
An Interactive Fiction by Team8
Release 1 / Serial number 180411 / Inform 7 build 6M62 (I6/v6.33 lib 6/12N) SD

Torbogen
Du Stehst unter dem Torbogen. Im Norden ist der Innenhof Parkplatz. Im Osten ist der Eingang zum Ostflügel. Im Westen ist der Eingang zum Westflügel. Im Süden ist ein Gehweg in Richtung Exer 11.

>s
Gehweg
Du stehst auf dem Gehweg. Von hier aus siehst du im Osten schon den Torbogen.

>w
Parkplatz
Du befindest dich auf dem Parkplatz vorm Exer 11. Im Osten siehst du einen Gehweg der Richtung Exer 2 führt.